######X#####
######X#####
#####XXXX###
XXXXXX##X###
########XX##
#########X##
#########X##
#########X##
######XXXX##
######X#####
#####XXXX###
XXXXXX##X###
########XX##
#########X##
#########X##
#########X##